WE ./textures/west.ppm
EA ./textures/east.ppm
NO ./textures/north.ppm
SO ./textures/south.ppm
F 242,242,242 
C 217, 184, 199


11111111111111
10000000000001
11111111111111111111111111111111
10000000000000000000000000000001
10000000001111111111101111011111
1000111111100000000000111110001
10000000101000000000001111111101
10001111 11100000000000000110001
10010000100000000000000001100001
10100000000000N00000000001100001
11111111111111111111111111111111


